11111111111111111111
10000000000C01010001
111100C0C011000E0001
1PC00C0100000C001001
11111111111111111111