11111111111111111111
1000P000000001100001
10000110000001100001
10000111000C00000001
1000E11C000110000001
10000000000110000001
11111111111111111111