11111111111111111111111111111111111
10000010000000000000100000000000001
10000001000000111001C10000000000001
10000000000CC000001CPC1000000000001
10000011000CC0000E00C10101000000001
100000110000000000000C0000000000001
11111111111111111111111111111111111